0WWWWWWWWWWWWWWW
0W0000000000000W
0W000000000000NW
0W000WWWWWWW000W
0W000W0P000W000W
0W000W00000W000W
0W000WWDDDWW000W
0W00000000000^0W
0W^^^^^^^^^^^^^W
0WWWWWWWWWWWWWWW